16 # 横方向のタイルの数
16 # 縦方向のタイルの数
20 # タイルの大きさ（px）
###########
# タイルのマップ（OとXは物体、Sはカメラの初期位置）
###########
................
OOOXXX...OOOO...
.....X...O......
.....X...O......
.....O...O......
.....OOOOO......
................
................
................
.....OOO........
..OOOO..........
..O....S........
..O.............
..OOOOOOOOO.....
................
................
###########
# EOF
###########
