14 # 横方向のタイルの数
18 # 縦方向のタイルの数
20 # タイルの大きさ（px）
###########
# タイルのマップ
###########
O.............
OOOOOOO.......
......O.......
...O..OOOOO...
...O..O.......
...OOOO.......
..............
..............
.OOOO....XXXX.
....O....X....
....O....X....
.OOOO....XXXX.
..............
..............
..........OOOO
..........OO..
..............
XXXXXX..XXXXXX
###########
# EOF
###########
