20 # 横方向のタイルの数
16 # 縦方向のタイルの数
16 # タイルの大きさ（px）
###########
# タイルのマップ（OとXは物体、Sはカメラの初期位置）
###########
....................
OOOOOO...OOOO.......
.....X...X..........
.....X...X..........
.....X...X..........
.....XXXXX..........
....................
....................
....................
.....OOO............
..OOOO..............
..O....S............
..O.................
..OOOOOOOOO.........
....................
....................
###########
# EOF
###########
